Joshua Fritcher : ğŸ¤©
Diann Hosmer : fun game
Laura Bradley : Pretty fun
lea young : great game
Colleen Wolf : Great game
paul thomas : simply excellent
Marta Louro : Very good
JoÃ£o Ralo : Awesome game
Nancy Bellavance : cute fun
Renae Batten : such fun
ggamergetch : awsome game
Sarvesh Yadav Sam : Excellent game
Jean Parker : fun addicting
Hemanta Patra Patra : Good game
Jayme Nicole Reed : cute game
Tamana Rezayee : not bad
oli marko : very fun
Tanu Shri : Nice application
XxNite4LifexX : Good puzzle
Scott Davey : I love it
yossinda dp : too cute
Kaye Rout : Awesome game
Regina RendÃ³n : amazing fame
Kerry Vanepps : Excellent game
Goodyelling yellgood : good game
dark wolf : very nice
Dander ã‚µãƒ– : Boring
Debbie N. : CUTENESS ğŸ’—
Emma S : love it ğŸ˜Š
Colby Evans : ğŸ¤™ğŸ¼ ğŸ¤™ğŸ¼
Becky Barry : ğŸ˜ğŸ¤©ğŸ˜ğŸ¤©ğŸ˜ğŸ¤©ğŸ˜ğŸ¤©ğŸ˜ğŸ¤©ğŸ˜ğŸ¤©ğŸ˜ğŸ¤©ğŸ˜ğŸ˜‚ğŸ˜ğŸ¤©ğŸ˜ğŸ˜ğŸ˜ğŸ˜ğŸ¤©ğŸ˜ğŸ¤©ğŸ˜ğŸ˜ğŸ¤©ğŸ˜ğŸ¤©ğŸ˜ğŸ¤©ğŸ¤©ğŸ˜ğŸ¤©ğŸ˜
Akar Hein : good ğŸ‘ ğŸ‘ ğŸ‘ ğŸ˜Š.
sean rood : Cool
Di Ashby : Fun
David A. : Fun
camilo ilaya : nice
Rashid alk : Awesome
Carlen cocoa : cool
Tym0n youtube : great
A Google user : interesting
Rajni Sasi : nice
Richard Brand : awesome
Manish Kedia : excellent
sualeha zaheer : Amazing
Shawn Gazafi : fun
Carrie Berger : Adorable
Moon Watcher : fun
Kyle DeWitt : fun
Savanna Fg : fun
Jelly Kang : good
kyaw Lin Aung : great
Thameem Ansari : Nice
Georgina Robinson : fun
Dawei Sayarmalay : good
Robert Birrell : Fun
Jean-Michelle Stanton : cute
Rena Swan : Fun
Lecia Carr : love it
V jeyanthi : nice
Ramkrishna Reddy : ğŸ‘©â€ğŸ‘§â€ğŸ‘§ğŸ“ğŸ—ğŸ¥¡ğŸŒğŸŸğŸ¿ğŸ«ğŸ‚ğŸ¢ğŸ¥³ğŸ¸ğŸš²ğŸš—ğŸ³ğŸ¥­ğŸ”ğŸ¥¤ğŸ­ğŸ›´ğŸ‰,
Omegakenshin Himura : Epic game
Peraveen Kumar : Great Game ğŸ‘
Kristina Korpar : Great game ğŸ‘ŒğŸ»ğŸ˜
G : Bravo majstori, evo vam i novci. Hvala na objavi na redditu, samo se nadam da Ä‡ete nastaviti raditi na igri
hlapichka : awesome!
Mustafa Tqu : Ù„Ø¹Ø¨Ø© Ù„Ø­Ù„ Ø§Ù„Ø§Ù„ØºØ§Ø² ÙˆØ§ÙŠØ¬Ø§Ø¯ Ø§Ù„Ù‚Ø·Ø· . Ø´Ø®ØµÙŠØ§ Ø§Ø¹ØªÙ‚Ø¯ Ù‡Ù†Ø§Ùƒ Ø§Ù„Ø¹Ø§Ø¨ Ø§ÙØ¶Ù„ ØªØ³ØªØ­Ù‚ ÙˆÙ‚ØªÙƒ
Niki Dibi : ĞÑ… Ğ´Ğ° Ğ¼Ğ½Ğµ Ğ¿Ğ¾Ğ½Ñ€Ğ°Ğ²Ğ¸Ğ»Ğ¾ÑÑŒ Ğ½Ğ°Ğ¼ Ğ¼Ğ½Ğµ Ğ¾Ğ¹ Ğ½Ğµ Ñ‚Ğ°ĞºĞ¾Ğ²ÑĞºĞ¸Ğ¹ Ñ‡ĞµĞ¼ĞÑ… Ğ´Ğ° Ğ¼Ğ½Ğµ Ğ¿Ğ¾Ğ½Ñ€Ğ°Ğ²Ğ¸Ğ»Ğ¾ÑÑŒ Ğ½Ğ°Ğ¼ Ğ¼Ğ½Ğµ Ğ¾Ğ¹ ĞĞµ Ñ‚Ğ°ĞºĞ¾Ğ²ÑĞºĞ¸Ğ¹
Cho Lay : I jerrry loving this game because I 12 year old and the game have so much fun!!! 5 star
Kate Bowen : Lived it.
idham aditya : cute game
Jaime De : CATS
deepika dee : Super
Suseela Balan : ğŸ‘
SYED HUZAIFA : Nice game
She post : InterestingğŸ¤”
Cheryle Langford : great
Nikhil Singh : nice
Che Jam Isa : Perfect
BigBoizInc. 1.0 : Fun
Monica Pena : Cute
Seema Ahmad : Good
April Wilson : AprilWilson
